------O-------
###-#######-###
--------------
-----------###-
------#----#--
#######-##-#---
-----#---#-#-*-
-------*-#-#---
-#####---#-----
-----#####-####
---#----#------
-*-#-------*-#-
---#----#----#-
-#############-
-------*------X
