------O-----------#--------------
###-#######-###-###-----*--------
-----------------*##########--###
--*--------###----#---*----#-----
------#----#------#--------#---#-
#######-##-#---#--###-######---#*
-----#---#-#-*-#---------------#-
-------*-#-#---#*----------------
-#####---#-----#--#####-#########
-----#####-######-#*-------------
---#----#------#--#-------------*
-*-#-------*-#----##############-
---#----#----#-##----------------
-#############-##-#######-#######
-------*------X---#-------------*
